NO ./textures/testing/wall.png
SO ./textures/testing/wall.png
WE ./textures/testing/wall.png
EA ./textures/testing/wall.png
F 240,233,133
C 225,100,200

11111111111111111111
11111111111111111111
10000000000000000001
10001111111111100001
10000000000000000001
10001111000111100001
10000000000000000001
10000000000000000001
10000N00010000000001
10000000010000000001
10000000010000000001
10000000000000000001
10000000000000010001
10011011000000010001
10010001000001111101
10011111000001000101
10000000000000000001
10000000000000000001
10000000000000000001
10000000000000000001
11111111111111111111
   11111    11111
   11111    11111
   11111    11111
   11111    11111