NO ./textures/testing/wall.png
SO ./textures/testing/wall.png
WE ./textures/testing/wall.png
EA ./textures/testing/wall.png
F 240,233,133
C 225,100,200

11111111111111111111111
11111111111111111111111
   10000000000000000001
   10001111111111100001
   10000000000000000001
   10000000000000000001
  110001111000111100001
11100000000000000000011
10000000000000000001111
10000000000000000001111
10000000000000000001111
10000N00010000000001111
11100000000100000000011
  110000000010000000001
11111100000000000000001
10000000000010110001111
10011011000010110001111
10010001000011111001111
10011111000001110001111
10000000000000000001111
10000000000000000001111
10000000000000000001111
11111111111111111111111