NO ./textures/testing/wall.png
SO ./textures/testing/wall.png
WE ./textures/testing/wall.png
EA ./textures/testing/wall.png
F 240,233,133
C 225,100,200

11111111111111111111111
1111111111111111111111111
1111110000000000000000001
11111100011111111111000011
1111110000000000000000001111
1111110000000000000000001111
11111100011110001111000011
1110000000000000000001111
10000000000000000001111
10000000000000000001
10000000000000000001
10000N00010000000001111
111000000001000000000111111
1111110000000010000000001111
111111110000000000000000001
111000000000001011000111111
10011011000010110001111
10010001000011111001111
10011111000001110001
10000000000000000001
10000000000000000001
10000000000000000001
11111111111111111111