NO ./textures/testing/wall.png
SO ./textures/testing/wall.png
WE ./textures/testing/wall.png
EA ./textures/testing/wall.png
F 240,233,133
C 225,100,200

11111111111111111111111
111111111111111111111111
   10000000000000000001
   100011111111111000011
   10000000000000000001111
   10000000000000000001111
  1100011110001111000011
11100000000000000000011
10000000000000000001111
10000000000000000001
100000000000000000011
10000N00010000000001111
111000000001000000000111111
  110000000010000000001111
  11110000000000000000001
1110000000000010110001111
10011011000010110001111
10010001000011111000111
100111110000011100011
10000000000000000001
10000000000000000001
10000000000000000001
11111111111111111111
   111111     11111
   111111     11111
   111111     11111
   111111     11111