NO ./textures/testing/wall.png
SO ./textures/testing/wall.png
WE ./textures/testing/wall.png
EA ./textures/testing/wall.png
F 240,233,133
C 225,100,200

11111111111111111111111
111111111111111111111111
   10000000000000000001
   100011111111111000011
   10000000000000000001111
   10000000000000000001111
111100011110001111000011
10000000000000000001111
10000000000000000001
10000000000000000001
10000000000000000001
10000N00010000000001
10000000010000000001
10000000010000000001
10000000000000000001
10000000000010110001
10011011000010110001
10010001000011111001
10011111000001110001
10000000000000000001
10000000000000000001
10000000000000000001
11111111111111111111