NO ./images/n.png
SO ./images/s.png
WE ./images/w.png
EA ./images/e.png
F 240,233,133
C 225,0,0

11111111111
1000000000111
10001W100000001
1000010000111
11111111111