NO ./textures/testing/test_1.png
SO ./textures/testing/test_2.png
WE ./textures/testing/test_3
EA ./textures/testing/test_4.png
F 240,233,133
C 225,0,210

11111111111
10000000001
10001W10001
10000100001
11111111111