NO ./images/n.png
SO ./images/s.png
WE ./images/w.png
wow
EA ./images/e.png
F 240,233,133
C 225,0,0

11111111111
10000000001
10001W10001
100001000x1
11111111111