NO ./images/n.png
SO ./images/s.png
WE ./images/w.png
EA ./images/e.png
F 240,233,133
C 225,0,0

1111111111111
100000000000001
10001W100000001
100001000011111
11111111111