NO ./images/n.png
SO ./images/s.png
WE ./images/w.png
EA ./images/e.png
F 2,233
C 2,2,1

11111111111
10000100001
10001W10001
10000000001
11111111111