NO ./images/n.png
SO ./images/s.png
WE ./images/w.png
EA ./images/e.png
F 240,233,133
C 225,0,0

11111111111
10000000001
10001W100011
1000010000001
11111111111110